11111111111111111111111111111
1000000000000000C0000C010E011
10100111111011101010111100101
10100100001000100010010000101
101001101010101000100100C0001
10100C00101010100000100100101
10100110101010101110010010101
10100100101000100010010000001
100000000011C100001C0000000C1
11111111111111111111111111111
