11111111111111111111111111111
10000000000000PC00000C0000001
10100111111011101010111000101
10100100001000100010010010101
101001101010101000100100C0001
10100C00101010100000100100101
10100110101010101110010010101
10100100101000100010010000001
100000000011C10000E10000000C1
11111111111111111111111111111
