111111
10CPE1
100101
101101
111111