111111111111111111111111111111
10000000000000P000000000000001
100000000000000000000000000001
10000000101000100C10E100000001
100000000000000000000000000001
100000000000000000000000000001
100000000000000000000000000001
100000000000000000000000000001
1000000000000000000000000000C1
111111111111111111111111111111