111111111111111111111111111111
10000T000000000P00X00000000001
1001111X11101110101111C11111G1
10G1C0001C100C100011E0000T0001
1011110T1000101T0010000X000001
1C1111001T10100000001001111101
10X11000001T1010111011011111C1
100T0001100000101100C101111101
10000G00C00X00T0000111C0000001
111111111111111111111111111111